Año,Trimestre,Provincia,Banda ancha fija,Dial up,Total,Banda ancha fija (M),Dial up (M),Total (M)
2022,3,Buenos Aires,4715469,6199,4721668,4.715469,0.006199,4.721668
2022,3,Capital Federal,1545534,2145,1547679,1.545534,0.002145,1.547679
2022,3,Catamarca,70292,1,70293,0.070292,1e-06,0.070293
2022,3,Chaco,144141,5,144146,0.144141,5e-06,0.144146
2022,3,Chubut,164874,904,165778,0.164874,0.000904,0.165778
2022,3,Córdoba,1038600,68,1038668,1.0386,6.8e-05,1.038668
2022,3,Corrientes,144842,4,144846,0.144842,4e-06,0.144846
2022,3,Entre Ríos,268937,22,268959,0.268937,2.2e-05,0.268959
2022,3,Formosa,68537,1,68538,0.068537,1e-06,0.068538
2022,3,Jujuy,118823,0,118823,0.118823,0.0,0.118823
2022,3,La Pampa,115921,171,116092,0.115921,0.000171,0.116092
2022,3,La Rioja,86860,4,86864,0.08686,4e-06,0.086864
2022,3,Mendoza,288746,777,289523,0.288746,0.000777,0.289523
2022,3,Misiones,182157,0,182157,0.182157,0.0,0.182157
2022,3,Neuquén,162693,468,163161,0.162693,0.000468,0.163161
2022,3,Río Negro,160010,548,160558,0.16001,0.000548,0.160558
2022,3,Salta,204536,5,204541,0.204536,5e-06,0.204541
2022,3,San Juan,103118,281,103399,0.103118,0.000281,0.103399
2022,3,San Luis,121888,182,122070,0.121888,0.000182,0.12207
2022,3,Santa Cruz,49312,198,49510,0.049312,0.000198,0.04951
2022,3,Santa Fe,887700,110,887810,0.8877,0.00011,0.88781
2022,3,Santiago Del Estero,119030,2,119032,0.11903,2e-06,0.119032
2022,3,Tierra Del Fuego,53584,312,53896,0.053584,0.000312,0.053896
2022,3,Tucumán,263087,30,263117,0.263087,3e-05,0.263117
2022,2,Buenos Aires,4660984,6199,4667183,4.660984,0.006199,4.667183
2022,2,Capital Federal,1534626,2145,1536771,1.534626,0.002145,1.536771
2022,2,Catamarca,67007,1,67008,0.067007,1e-06,0.067008
2022,2,Chaco,143559,5,143564,0.143559,5e-06,0.143564
2022,2,Chubut,161901,904,162805,0.161901,0.000904,0.162805
2022,2,Córdoba,1026367,68,1026435,1.026367,6.8e-05,1.026435
2022,2,Corrientes,144993,4,144997,0.144993,4e-06,0.144997
2022,2,Entre Ríos,269330,22,269352,0.26933,2.2e-05,0.269352
2022,2,Formosa,67881,0,67881,0.067881,0.0,0.067881
2022,2,Jujuy,115314,0,115314,0.115314,0.0,0.115314
2022,2,La Pampa,111356,171,111527,0.111356,0.000171,0.111527
2022,2,La Rioja,86026,4,86030,0.086026,4e-06,0.08603
2022,2,Mendoza,278785,777,279562,0.278785,0.000777,0.279562
2022,2,Misiones,178813,0,178813,0.178813,0.0,0.178813
2022,2,Neuquén,161500,468,161968,0.1615,0.000468,0.161968
2022,2,Río Negro,159216,548,159764,0.159216,0.000548,0.159764
2022,2,Salta,203172,5,203177,0.203172,5e-06,0.203177
2022,2,San Juan,100126,281,100407,0.100126,0.000281,0.100407
2022,2,San Luis,121559,182,121741,0.121559,0.000182,0.121741
2022,2,Santa Cruz,48987,198,49185,0.048987,0.000198,0.049185
2022,2,Santa Fe,878749,110,878859,0.878749,0.00011,0.878859
2022,2,Santiago Del Estero,118042,2,118044,0.118042,2e-06,0.118044
2022,2,Tierra Del Fuego,53458,312,53770,0.053458,0.000312,0.05377
2022,2,Tucumán,254497,30,254527,0.254497,3e-05,0.254527
2022,1,Buenos Aires,4549131,6293,4555424,4.549131,0.006293,4.555424
2022,1,Capital Federal,1415378,2163,1417541,1.415378,0.002163,1.417541
2022,1,Catamarca,62377,1,62378,0.062377,1e-06,0.062378
2022,1,Chaco,144114,5,144119,0.144114,5e-06,0.144119
2022,1,Chubut,170701,927,171628,0.170701,0.000927,0.171628
2022,1,Córdoba,1003729,74,1003803,1.003729,7.4e-05,1.003803
2022,1,Corrientes,142574,4,142578,0.142574,4e-06,0.142578
2022,1,Entre Ríos,267904,22,267926,0.267904,2.2e-05,0.267926
2022,1,Formosa,54548,0,54548,0.054548,0.0,0.054548
2022,1,Jujuy,116509,0,116509,0.116509,0.0,0.116509
2022,1,La Pampa,109560,172,109732,0.10956,0.000172,0.109732
2022,1,La Rioja,84299,4,84303,0.084299,4e-06,0.084303
2022,1,Mendoza,274399,786,275185,0.274399,0.000786,0.275185
2022,1,Misiones,171508,0,171508,0.171508,0.0,0.171508
2022,1,Neuquén,149208,471,149679,0.149208,0.000471,0.149679
2022,1,Río Negro,156821,553,157374,0.156821,0.000553,0.157374
2022,1,Salta,197510,5,197515,0.19751,5e-06,0.197515
2022,1,San Juan,87888,290,88178,0.087888,0.00029,0.088178
2022,1,San Luis,119659,185,119844,0.119659,0.000185,0.119844
2022,1,Santa Cruz,48898,204,49102,0.048898,0.000204,0.049102
2022,1,Santa Fe,870364,115,870479,0.870364,0.000115,0.870479
2022,1,Santiago Del Estero,116459,2,116461,0.116459,2e-06,0.116461
2022,1,Tierra Del Fuego,52298,313,52611,0.052298,0.000313,0.052611
2022,1,Tucumán,245554,30,245584,0.245554,3e-05,0.245584
2021,4,Buenos Aires,4502772,6385,4509157,4.502772,0.006385,4.509157
2021,4,Capital Federal,1409935,2184,1412119,1.409935,0.002184,1.412119
2021,4,Catamarca,59089,1,59090,0.059089,1e-06,0.05909
2021,4,Chaco,143740,5,143745,0.14374,5e-06,0.143745
2021,4,Chubut,159364,944,160308,0.159364,0.000944,0.160308
2021,4,Córdoba,986693,77,986770,0.986693,7.7e-05,0.98677
2021,4,Corrientes,135908,4,135912,0.135908,4e-06,0.135912
2021,4,Entre Ríos,265024,22,265046,0.265024,2.2e-05,0.265046
2021,4,Formosa,53663,0,53663,0.053663,0.0,0.053663
2021,4,Jujuy,113915,0,113915,0.113915,0.0,0.113915
2021,4,La Pampa,106834,173,107007,0.106834,0.000173,0.107007
2021,4,La Rioja,83124,4,83128,0.083124,4e-06,0.083128
2021,4,Mendoza,266783,804,267587,0.266783,0.000804,0.267587
2021,4,Misiones,171132,0,171132,0.171132,0.0,0.171132
2021,4,Neuquén,146989,477,147466,0.146989,0.000477,0.147466
2021,4,Río Negro,153189,564,153753,0.153189,0.000564,0.153753
2021,4,Salta,199399,6,199405,0.199399,6e-06,0.199405
2021,4,San Juan,79667,291,79958,0.079667,0.000291,0.079958
2021,4,San Luis,118662,187,118849,0.118662,0.000187,0.118849
2021,4,Santa Cruz,48276,210,48486,0.048276,0.00021,0.048486
2021,4,Santa Fe,866265,176,866441,0.866265,0.000176,0.866441
2021,4,Santiago Del Estero,115859,2,115861,0.115859,2e-06,0.115861
2021,4,Tierra Del Fuego,52042,315,52357,0.052042,0.000315,0.052357
2021,4,Tucumán,238609,30,238639,0.238609,3e-05,0.238639
2021,3,Buenos Aires,4246425,5184,4251609,4.246425,0.005184,4.251609
2021,3,Capital Federal,1411797,1608,1413405,1.411797,0.001608,1.413405
2021,3,Catamarca,56253,1,56254,0.056253,1e-06,0.056254
2021,3,Chaco,139868,3,139871,0.139868,3e-06,0.139871
2021,3,Chubut,155266,800,156066,0.155266,0.0008,0.156066
2021,3,Córdoba,946726,62,946788,0.946726,6.2e-05,0.946788
2021,3,Corrientes,133816,3,133819,0.133816,3e-06,0.133819
2021,3,Entre Ríos,260360,15,260375,0.26036,1.5e-05,0.260375
2021,3,Formosa,52795,0,52795,0.052795,0.0,0.052795
2021,3,Jujuy,111158,0,111158,0.111158,0.0,0.111158
2021,3,La Pampa,100371,116,100487,0.100371,0.000116,0.100487
2021,3,La Rioja,82157,3,82160,0.082157,3e-06,0.08216
2021,3,Mendoza,255320,619,255939,0.25532,0.000619,0.255939
2021,3,Misiones,158528,0,158528,0.158528,0.0,0.158528
2021,3,Neuquén,139436,373,139809,0.139436,0.000373,0.139809
2021,3,Río Negro,144084,501,144585,0.144084,0.000501,0.144585
2021,3,Salta,195831,2,195833,0.195831,2e-06,0.195833
2021,3,San Juan,79227,256,79483,0.079227,0.000256,0.079483
2021,3,San Luis,117716,148,117864,0.117716,0.000148,0.117864
2021,3,Santa Cruz,48779,197,48976,0.048779,0.000197,0.048976
2021,3,Santa Fe,841433,151,841584,0.841433,0.000151,0.841584
2021,3,Santiago Del Estero,115457,1,115458,0.115457,1e-06,0.115458
2021,3,Tierra Del Fuego,49934,289,50223,0.049934,0.000289,0.050223
2021,3,Tucumán,232447,25,232472,0.232447,2.5e-05,0.232472
2021,2,Buenos Aires,4127167,5184,4132351,4.127167,0.005184,4.132351
2021,2,Capital Federal,1398747,1608,1400355,1.398747,0.001608,1.400355
2021,2,Catamarca,55743,1,55744,0.055743,1e-06,0.055744
2021,2,Chaco,140726,3,140729,0.140726,3e-06,0.140729
2021,2,Chubut,138412,825,139237,0.138412,0.000825,0.139237
2021,2,Córdoba,930818,62,930880,0.930818,6.2e-05,0.93088
2021,2,Corrientes,129498,3,129501,0.129498,3e-06,0.129501
2021,2,Entre Ríos,257617,15,257632,0.257617,1.5e-05,0.257632
2021,2,Formosa,51551,0,51551,0.051551,0.0,0.051551
2021,2,Jujuy,111848,0,111848,0.111848,0.0,0.111848
2021,2,La Pampa,97551,116,97667,0.097551,0.000116,0.097667
2021,2,La Rioja,81599,3,81602,0.081599,3e-06,0.081602
2021,2,Mendoza,229052,619,229671,0.229052,0.000619,0.229671
2021,2,Misiones,156176,0,156176,0.156176,0.0,0.156176
2021,2,Neuquén,137877,373,138250,0.137877,0.000373,0.13825
2021,2,Río Negro,143583,501,144084,0.143583,0.000501,0.144084
2021,2,Salta,191637,2,191639,0.191637,2e-06,0.191639
2021,2,San Juan,78677,256,78933,0.078677,0.000256,0.078933
2021,2,San Luis,122670,148,122818,0.12267,0.000148,0.122818
2021,2,Santa Cruz,48785,197,48982,0.048785,0.000197,0.048982
2021,2,Santa Fe,840449,151,840600,0.840449,0.000151,0.8406
2021,2,Santiago Del Estero,114089,1,114090,0.114089,1e-06,0.11409
2021,2,Tierra Del Fuego,35404,289,35693,0.035404,0.000289,0.035693
2021,2,Tucumán,233026,25,233051,0.233026,2.5e-05,0.233051
2021,1,Buenos Aires,4054936,5066,4060002,4.054936,0.005066,4.060002
2021,1,Capital Federal,1378283,1390,1379673,1.378283,0.00139,1.379673
2021,1,Catamarca,51967,1,51968,0.051967,1e-06,0.051968
2021,1,Chaco,139767,3,139770,0.139767,3e-06,0.13977
2021,1,Chubut,131515,825,132340,0.131515,0.000825,0.13234
2021,1,Córdoba,910826,55,910881,0.910826,5.5e-05,0.910881
2021,1,Corrientes,126622,3,126625,0.126622,3e-06,0.126625
2021,1,Entre Ríos,251950,13,251963,0.25195,1.3e-05,0.251963
2021,1,Formosa,50686,0,50686,0.050686,0.0,0.050686
2021,1,Jujuy,110456,0,110456,0.110456,0.0,0.110456
2021,1,La Pampa,96989,116,97105,0.096989,0.000116,0.097105
2021,1,La Rioja,52625,3,52628,0.052625,3e-06,0.052628
2021,1,Mendoza,218308,615,218923,0.218308,0.000615,0.218923
2021,1,Misiones,149387,0,149387,0.149387,0.0,0.149387
2021,1,Neuquén,132862,373,133235,0.132862,0.000373,0.133235
2021,1,Río Negro,140667,501,141168,0.140667,0.000501,0.141168
2021,1,Salta,187572,2,187574,0.187572,2e-06,0.187574
2021,1,San Juan,78011,256,78267,0.078011,0.000256,0.078267
2021,1,San Luis,119006,148,119154,0.119006,0.000148,0.119154
2021,1,Santa Cruz,45868,197,46065,0.045868,0.000197,0.046065
2021,1,Santa Fe,825990,137,826127,0.82599,0.000137,0.826127
2021,1,Santiago Del Estero,111640,1,111641,0.11164,1e-06,0.111641
2021,1,Tierra Del Fuego,40133,289,40422,0.040133,0.000289,0.040422
2021,1,Tucumán,231890,22,231912,0.23189,2.2e-05,0.231912
2020,4,Buenos Aires,4028195,5066,4033261,4.028195,0.005066,4.033261
2020,4,Capital Federal,1378140,1390,1379530,1.37814,0.00139,1.37953
2020,4,Catamarca,52395,1,52396,0.052395,1e-06,0.052396
2020,4,Chaco,139088,3,139091,0.139088,3e-06,0.139091
2020,4,Chubut,129749,825,130574,0.129749,0.000825,0.130574
2020,4,Córdoba,902646,55,902701,0.902646,5.5e-05,0.902701
2020,4,Corrientes,125656,3,125659,0.125656,3e-06,0.125659
2020,4,Entre Ríos,247368,13,247381,0.247368,1.3e-05,0.247381
2020,4,Formosa,50206,0,50206,0.050206,0.0,0.050206
2020,4,Jujuy,105851,0,105851,0.105851,0.0,0.105851
2020,4,La Pampa,96779,116,96895,0.096779,0.000116,0.096895
2020,4,La Rioja,52775,3,52778,0.052775,3e-06,0.052778
2020,4,Mendoza,214838,615,215453,0.214838,0.000615,0.215453
2020,4,Misiones,147161,0,147161,0.147161,0.0,0.147161
2020,4,Neuquén,132762,373,133135,0.132762,0.000373,0.133135
2020,4,Río Negro,140709,501,141210,0.140709,0.000501,0.14121
2020,4,Salta,187388,2,187390,0.187388,2e-06,0.18739
2020,4,San Juan,72340,256,72596,0.07234,0.000256,0.072596
2020,4,San Luis,119287,148,119435,0.119287,0.000148,0.119435
2020,4,Santa Cruz,40477,197,40674,0.040477,0.000197,0.040674
2020,4,Santa Fe,820676,137,820813,0.820676,0.000137,0.820813
2020,4,Santiago Del Estero,106668,1,106669,0.106668,1e-06,0.106669
2020,4,Tierra Del Fuego,39325,289,39614,0.039325,0.000289,0.039614
2020,4,Tucumán,231067,22,231089,0.231067,2.2e-05,0.231089
2020,3,Buenos Aires,3932211,5066,3937277,3.932211,0.005066,3.937277
2020,3,Capital Federal,1371285,1390,1372675,1.371285,0.00139,1.372675
2020,3,Catamarca,49903,1,49904,0.049903,1e-06,0.049904
2020,3,Chaco,133951,3,133954,0.133951,3e-06,0.133954
2020,3,Chubut,129202,825,130027,0.129202,0.000825,0.130027
2020,3,Córdoba,867417,55,867472,0.867417,5.5e-05,0.867472
2020,3,Corrientes,123388,3,123391,0.123388,3e-06,0.123391
2020,3,Entre Ríos,241482,13,241495,0.241482,1.3e-05,0.241495
2020,3,Formosa,49209,0,49209,0.049209,0.0,0.049209
2020,3,Jujuy,106728,0,106728,0.106728,0.0,0.106728
2020,3,La Pampa,93619,116,93735,0.093619,0.000116,0.093735
2020,3,La Rioja,52613,3,52616,0.052613,3e-06,0.052616
2020,3,Mendoza,207173,615,207788,0.207173,0.000615,0.207788
2020,3,Misiones,143186,0,143186,0.143186,0.0,0.143186
2020,3,Neuquén,128862,373,129235,0.128862,0.000373,0.129235
2020,3,Río Negro,130966,501,131467,0.130966,0.000501,0.131467
2020,3,Salta,180844,2,180846,0.180844,2e-06,0.180846
2020,3,San Juan,77071,256,77327,0.077071,0.000256,0.077327
2020,3,San Luis,116417,148,116565,0.116417,0.000148,0.116565
2020,3,Santa Cruz,39084,197,39281,0.039084,0.000197,0.039281
2020,3,Santa Fe,802861,137,802998,0.802861,0.000137,0.802998
2020,3,Santiago Del Estero,105491,1,105492,0.105491,1e-06,0.105492
2020,3,Tierra Del Fuego,39366,289,39655,0.039366,0.000289,0.039655
2020,3,Tucumán,223854,22,223876,0.223854,2.2e-05,0.223876
2020,2,Buenos Aires,3772480,5066,3777546,3.77248,0.005066,3.777546
2020,2,Capital Federal,1356431,1390,1357821,1.356431,0.00139,1.357821
2020,2,Catamarca,47975,1,47976,0.047975,1e-06,0.047976
2020,2,Chaco,128129,3,128132,0.128129,3e-06,0.128132
2020,2,Chubut,107831,825,108656,0.107831,0.000825,0.108656
2020,2,Córdoba,836413,55,836468,0.836413,5.5e-05,0.836468
2020,2,Corrientes,118863,3,118866,0.118863,3e-06,0.118866
2020,2,Entre Ríos,234100,13,234113,0.2341,1.3e-05,0.234113
2020,2,Formosa,47932,0,47932,0.047932,0.0,0.047932
2020,2,Jujuy,94316,0,94316,0.094316,0.0,0.094316
2020,2,La Pampa,89693,116,89809,0.089693,0.000116,0.089809
2020,2,La Rioja,52152,3,52155,0.052152,3e-06,0.052155
2020,2,Mendoza,200569,615,201184,0.200569,0.000615,0.201184
2020,2,Misiones,140340,0,140340,0.14034,0.0,0.14034
2020,2,Neuquén,125799,373,126172,0.125799,0.000373,0.126172
2020,2,Río Negro,128985,501,129486,0.128985,0.000501,0.129486
2020,2,Salta,177760,2,177762,0.17776,2e-06,0.177762
2020,2,San Juan,69521,256,69777,0.069521,0.000256,0.069777
2020,2,San Luis,113804,148,113952,0.113804,0.000148,0.113952
2020,2,Santa Cruz,38672,197,38869,0.038672,0.000197,0.038869
2020,2,Santa Fe,777795,137,777932,0.777795,0.000137,0.777932
2020,2,Santiago Del Estero,105446,1,105447,0.105446,1e-06,0.105447
2020,2,Tierra Del Fuego,38900,289,39189,0.0389,0.000289,0.039189
2020,2,Tucumán,217134,22,217156,0.217134,2.2e-05,0.217156
2020,1,Buenos Aires,3702985,5066,3708051,3.702985,0.005066,3.708051
2020,1,Capital Federal,1352104,1390,1353494,1.352104,0.00139,1.353494
2020,1,Catamarca,39634,1,39635,0.039634,1e-06,0.039635
2020,1,Chaco,120274,3,120277,0.120274,3e-06,0.120277
2020,1,Chubut,95938,800,96738,0.095938,0.0008,0.096738
2020,1,Córdoba,811044,55,811099,0.811044,5.5e-05,0.811099
2020,1,Corrientes,113967,3,113970,0.113967,3e-06,0.11397
2020,1,Entre Ríos,231833,13,231846,0.231833,1.3e-05,0.231846
2020,1,Formosa,46434,0,46434,0.046434,0.0,0.046434
2020,1,Jujuy,91665,0,91665,0.091665,0.0,0.091665
2020,1,La Pampa,89110,116,89226,0.08911,0.000116,0.089226
2020,1,La Rioja,48337,3,48340,0.048337,3e-06,0.04834
2020,1,Mendoza,182837,615,183452,0.182837,0.000615,0.183452
2020,1,Misiones,133552,0,133552,0.133552,0.0,0.133552
2020,1,Neuquén,121354,373,121727,0.121354,0.000373,0.121727
2020,1,Río Negro,125699,501,126200,0.125699,0.000501,0.1262
2020,1,Salta,170379,2,170381,0.170379,2e-06,0.170381
2020,1,San Juan,63975,256,64231,0.063975,0.000256,0.064231
2020,1,San Luis,110404,148,110552,0.110404,0.000148,0.110552
2020,1,Santa Cruz,38625,197,38822,0.038625,0.000197,0.038822
2020,1,Santa Fe,770981,137,771118,0.770981,0.000137,0.771118
2020,1,Santiago Del Estero,102754,1,102755,0.102754,1e-06,0.102755
2020,1,Tierra Del Fuego,38505,289,38794,0.038505,0.000289,0.038794
2020,1,Tucumán,200045,22,200067,0.200045,2.2e-05,0.200067
2019,4,Buenos Aires,3681120,5134,3686254,3.68112,0.005134,3.686254
2019,4,Capital Federal,1356695,1410,1358105,1.356695,0.00141,1.358105
2019,4,Catamarca,38310,1,38311,0.03831,1e-06,0.038311
2019,4,Chaco,117900,3,117903,0.1179,3e-06,0.117903
2019,4,Chubut,95292,810,96102,0.095292,0.00081,0.096102
2019,4,Córdoba,806633,55,806688,0.806633,5.5e-05,0.806688
2019,4,Corrientes,113831,3,113834,0.113831,3e-06,0.113834
2019,4,Entre Ríos,239017,13,239030,0.239017,1.3e-05,0.23903
2019,4,Formosa,46711,0,46711,0.046711,0.0,0.046711
2019,4,Jujuy,88881,0,88881,0.088881,0.0,0.088881
2019,4,La Pampa,90280,119,90399,0.09028,0.000119,0.090399
2019,4,La Rioja,48999,3,49002,0.048999,3e-06,0.049002
2019,4,Mendoza,185157,623,185780,0.185157,0.000623,0.18578
2019,4,Misiones,135813,0,135813,0.135813,0.0,0.135813
2019,4,Neuquén,116069,376,116445,0.116069,0.000376,0.116445
2019,4,Río Negro,126636,504,127140,0.126636,0.000504,0.12714
2019,4,Salta,172443,2,172445,0.172443,2e-06,0.172445
2019,4,San Juan,64715,259,64974,0.064715,0.000259,0.064974
2019,4,San Luis,108053,148,108201,0.108053,0.000148,0.108201
2019,4,Santa Cruz,39170,200,39370,0.03917,0.0002,0.03937
2019,4,Santa Fe,769019,150,769169,0.769019,0.00015,0.769169
2019,4,Santiago Del Estero,103587,1,103588,0.103587,1e-06,0.103588
2019,4,Tierra Del Fuego,40101,291,40392,0.040101,0.000291,0.040392
2019,4,Tucumán,198621,23,198644,0.198621,2.3e-05,0.198644
2019,3,Buenos Aires,3950114,10119,3960233,3.950114,0.010119,3.960233
2019,3,Capital Federal,1437734,3477,1441211,1.437734,0.003477,1.441211
2019,3,Catamarca,32391,9,32400,0.032391,9e-06,0.0324
2019,3,Chaco,114438,13,114451,0.114438,1.3e-05,0.114451
2019,3,Chubut,87481,1524,89005,0.087481,0.001524,0.089005
2019,3,Córdoba,782946,107,783053,0.782946,0.000107,0.783053
2019,3,Corrientes,112749,10,112759,0.112749,1e-05,0.112759
2019,3,Entre Ríos,238057,45,238102,0.238057,4.5e-05,0.238102
2019,3,Formosa,46066,0,46066,0.046066,0.0,0.046066
2019,3,Jujuy,86575,1,86576,0.086575,1e-06,0.086576
2019,3,La Pampa,90559,269,90828,0.090559,0.000269,0.090828
2019,3,La Rioja,49659,18,49677,0.049659,1.8e-05,0.049677
2019,3,Mendoza,223015,1322,224337,0.223015,0.001322,0.224337
2019,3,Misiones,133883,0,133883,0.133883,0.0,0.133883
2019,3,Neuquén,123435,1986,125421,0.123435,0.001986,0.125421
2019,3,Río Negro,143391,904,144295,0.143391,0.000904,0.144295
2019,3,Salta,151834,1,151835,0.151834,1e-06,0.151835
2019,3,San Juan,72535,563,73098,0.072535,0.000563,0.073098
2019,3,San Luis,122409,291,122700,0.122409,0.000291,0.1227
2019,3,Santa Cruz,37642,328,37970,0.037642,0.000328,0.03797
2019,3,Santa Fe,760706,228,760934,0.760706,0.000228,0.760934
2019,3,Santiago Del Estero,133130,2,133132,0.13313,2e-06,0.133132
2019,3,Tierra Del Fuego,48043,544,48587,0.048043,0.000544,0.048587
2019,3,Tucumán,164099,32,164131,0.164099,3.2e-05,0.164131
2019,2,Buenos Aires,3845594,10104,3855698,3.845594,0.010104,3.855698
2019,2,Capital Federal,1412177,3443,1415620,1.412177,0.003443,1.41562
2019,2,Catamarca,33626,9,33635,0.033626,9e-06,0.033635
2019,2,Chaco,108721,13,108734,0.108721,1.3e-05,0.108734
2019,2,Chubut,86038,1518,87556,0.086038,0.001518,0.087556
2019,2,Córdoba,775023,105,775128,0.775023,0.000105,0.775128
2019,2,Corrientes,111539,10,111549,0.111539,1e-05,0.111549
2019,2,Entre Ríos,235780,44,235824,0.23578,4.4e-05,0.235824
2019,2,Formosa,46438,0,46438,0.046438,0.0,0.046438
2019,2,Jujuy,86706,1,86707,0.086706,1e-06,0.086707
2019,2,La Pampa,89937,268,90205,0.089937,0.000268,0.090205
2019,2,La Rioja,50283,18,50301,0.050283,1.8e-05,0.050301
2019,2,Mendoza,222535,1322,223857,0.222535,0.001322,0.223857
2019,2,Misiones,132878,0,132878,0.132878,0.0,0.132878
2019,2,Neuquén,120954,1999,122953,0.120954,0.001999,0.122953
2019,2,Río Negro,137632,915,138547,0.137632,0.000915,0.138547
2019,2,Salta,142567,1,142568,0.142567,1e-06,0.142568
2019,2,San Juan,69461,564,70025,0.069461,0.000564,0.070025
2019,2,San Luis,117094,291,117385,0.117094,0.000291,0.117385
2019,2,Santa Cruz,30225,325,30550,0.030225,0.000325,0.03055
2019,2,Santa Fe,743258,226,743484,0.743258,0.000226,0.743484
2019,2,Santiago Del Estero,126752,2,126754,0.126752,2e-06,0.126754
2019,2,Tierra Del Fuego,46910,544,47454,0.04691,0.000544,0.047454
2019,2,Tucumán,166299,32,166331,0.166299,3.2e-05,0.166331
2019,1,Buenos Aires,3736563,10104,3746667,3.736563,0.010104,3.746667
2019,1,Capital Federal,1396157,3443,1399600,1.396157,0.003443,1.3996
2019,1,Catamarca,33613,9,33622,0.033613,9e-06,0.033622
2019,1,Chaco,103664,13,103677,0.103664,1.3e-05,0.103677
2019,1,Chubut,78260,1518,79778,0.07826,0.001518,0.079778
2019,1,Córdoba,744010,105,744115,0.74401,0.000105,0.744115
2019,1,Corrientes,102477,10,102487,0.102477,1e-05,0.102487
2019,1,Entre Ríos,232403,44,232447,0.232403,4.4e-05,0.232447
2019,1,Formosa,45211,0,45211,0.045211,0.0,0.045211
2019,1,Jujuy,90146,1,90147,0.090146,1e-06,0.090147
2019,1,La Pampa,88892,268,89160,0.088892,0.000268,0.08916
2019,1,La Rioja,51638,18,51656,0.051638,1.8e-05,0.051656
2019,1,Mendoza,204976,1322,206298,0.204976,0.001322,0.206298
2019,1,Misiones,122720,0,122720,0.12272,0.0,0.12272
2019,1,Neuquén,112321,2056,114377,0.112321,0.002056,0.114377
2019,1,Río Negro,120173,915,121088,0.120173,0.000915,0.121088
2019,1,Salta,136019,1,136020,0.136019,1e-06,0.13602
2019,1,San Juan,61881,564,62445,0.061881,0.000564,0.062445
2019,1,San Luis,96044,291,96335,0.096044,0.000291,0.096335
2019,1,Santa Cruz,24580,325,24905,0.02458,0.000325,0.024905
2019,1,Santa Fe,736851,227,737078,0.736851,0.000227,0.737078
2019,1,Santiago Del Estero,89851,2,89853,0.089851,2e-06,0.089853
2019,1,Tierra Del Fuego,45903,544,46447,0.045903,0.000544,0.046447
2019,1,Tucumán,171970,32,172002,0.17197,3.2e-05,0.172002
2018,4,Buenos Aires,3626502,10104,3636606,3.626502,0.010104,3.636606
2018,4,Capital Federal,1385577,3443,1389020,1.385577,0.003443,1.38902
2018,4,Catamarca,33574,9,33583,0.033574,9e-06,0.033583
2018,4,Chaco,103257,13,103270,0.103257,1.3e-05,0.10327
2018,4,Chubut,77204,1518,78722,0.077204,0.001518,0.078722
2018,4,Córdoba,737234,105,737339,0.737234,0.000105,0.737339
2018,4,Corrientes,100591,10,100601,0.100591,1e-05,0.100601
2018,4,Entre Ríos,222003,44,222047,0.222003,4.4e-05,0.222047
2018,4,Formosa,45204,0,45204,0.045204,0.0,0.045204
2018,4,Jujuy,90132,1,90133,0.090132,1e-06,0.090133
2018,4,La Pampa,85368,268,85636,0.085368,0.000268,0.085636
2018,4,La Rioja,51633,18,51651,0.051633,1.8e-05,0.051651
2018,4,Mendoza,204982,1322,206304,0.204982,0.001322,0.206304
2018,4,Misiones,116273,0,116273,0.116273,0.0,0.116273
2018,4,Neuquén,112309,2056,114365,0.112309,0.002056,0.114365
2018,4,Río Negro,115922,915,116837,0.115922,0.000915,0.116837
2018,4,Salta,134577,1,134578,0.134577,1e-06,0.134578
2018,4,San Juan,61834,564,62398,0.061834,0.000564,0.062398
2018,4,San Luis,96040,291,96331,0.09604,0.000291,0.096331
2018,4,Santa Cruz,24443,325,24768,0.024443,0.000325,0.024768
2018,4,Santa Fe,720161,229,720390,0.720161,0.000229,0.72039
2018,4,Santiago Del Estero,89333,2,89335,0.089333,2e-06,0.089335
2018,4,Tierra Del Fuego,45716,544,46260,0.045716,0.000544,0.04626
2018,4,Tucumán,171972,32,172004,0.171972,3.2e-05,0.172004
2018,3,Buenos Aires,3599714,10563,3610277,3.599714,0.010563,3.610277
2018,3,Capital Federal,1385804,6686,1392490,1.385804,0.006686,1.39249
2018,3,Catamarca,34215,11,34226,0.034215,1.1e-05,0.034226
2018,3,Chaco,102021,12,102033,0.102021,1.2e-05,0.102033
2018,3,Chubut,101310,2426,103736,0.10131,0.002426,0.103736
2018,3,Córdoba,725764,94,725858,0.725764,9.4e-05,0.725858
2018,3,Corrientes,99445,11,99456,0.099445,1.1e-05,0.099456
2018,3,Entre Ríos,204560,48,204608,0.20456,4.8e-05,0.204608
2018,3,Formosa,44865,0,44865,0.044865,0.0,0.044865
2018,3,Jujuy,44934,1,44935,0.044934,1e-06,0.044935
2018,3,La Pampa,83180,244,83424,0.08318,0.000244,0.083424
2018,3,La Rioja,51855,17,51872,0.051855,1.7e-05,0.051872
2018,3,Mendoza,205545,1484,207029,0.205545,0.001484,0.207029
2018,3,Misiones,108042,0,108042,0.108042,0.0,0.108042
2018,3,Neuquén,114713,2005,116718,0.114713,0.002005,0.116718
2018,3,Río Negro,112433,1059,113492,0.112433,0.001059,0.113492
2018,3,Salta,132882,1,132883,0.132882,1e-06,0.132883
2018,3,San Juan,63823,658,64481,0.063823,0.000658,0.064481
2018,3,San Luis,74121,300,74421,0.074121,0.0003,0.074421
2018,3,Santa Cruz,33565,434,33999,0.033565,0.000434,0.033999
2018,3,Santa Fe,694883,217,695100,0.694883,0.000217,0.6951
2018,3,Santiago Del Estero,86358,2,86360,0.086358,2e-06,0.08636
2018,3,Tierra Del Fuego,45056,508,45564,0.045056,0.000508,0.045564
2018,3,Tucumán,171135,31,171166,0.171135,3.1e-05,0.171166
2018,2,Buenos Aires,3490134,10565,3500699,3.490134,0.010565,3.500699
2018,2,Capital Federal,1362498,6688,1369186,1.362498,0.006688,1.369186
2018,2,Catamarca,34078,11,34089,0.034078,1.1e-05,0.034089
2018,2,Chaco,98509,12,98521,0.098509,1.2e-05,0.098521
2018,2,Chubut,98137,2427,100564,0.098137,0.002427,0.100564
2018,2,Córdoba,712979,94,713073,0.712979,9.4e-05,0.713073
2018,2,Corrientes,97946,11,97957,0.097946,1.1e-05,0.097957
2018,2,Entre Ríos,199937,48,199985,0.199937,4.8e-05,0.199985
2018,2,Formosa,44554,0,44554,0.044554,0.0,0.044554
2018,2,Jujuy,45132,1,45133,0.045132,1e-06,0.045133
2018,2,La Pampa,82177,244,82421,0.082177,0.000244,0.082421
2018,2,La Rioja,51931,17,51948,0.051931,1.7e-05,0.051948
2018,2,Mendoza,199468,1484,200952,0.199468,0.001484,0.200952
2018,2,Misiones,106147,0,106147,0.106147,0.0,0.106147
2018,2,Neuquén,113842,2006,115848,0.113842,0.002006,0.115848
2018,2,Río Negro,111176,1059,112235,0.111176,0.001059,0.112235
2018,2,Salta,134166,1,134167,0.134166,1e-06,0.134167
2018,2,San Juan,63443,658,64101,0.063443,0.000658,0.064101
2018,2,San Luis,21168,300,21468,0.021168,0.0003,0.021468
2018,2,Santa Cruz,33970,435,34405,0.03397,0.000435,0.034405
2018,2,Santa Fe,684243,309,684552,0.684243,0.000309,0.684552
2018,2,Santiago Del Estero,83773,2,83775,0.083773,2e-06,0.083775
2018,2,Tierra Del Fuego,44199,508,44707,0.044199,0.000508,0.044707
2018,2,Tucumán,169926,31,169957,0.169926,3.1e-05,0.169957
2018,1,Buenos Aires,3464882,10564,3475446,3.464882,0.010564,3.475446
2018,1,Capital Federal,1359882,6688,1366570,1.359882,0.006688,1.36657
2018,1,Catamarca,33934,11,33945,0.033934,1.1e-05,0.033945
2018,1,Chaco,96925,12,96937,0.096925,1.2e-05,0.096937
2018,1,Chubut,95532,2427,97959,0.095532,0.002427,0.097959
2018,1,Córdoba,713825,101,713926,0.713825,0.000101,0.713926
2018,1,Corrientes,94406,11,94417,0.094406,1.1e-05,0.094417
2018,1,Entre Ríos,197346,48,197394,0.197346,4.8e-05,0.197394
2018,1,Formosa,32328,0,32328,0.032328,0.0,0.032328
2018,1,Jujuy,44405,1,44406,0.044405,1e-06,0.044406
2018,1,La Pampa,82668,396,83064,0.082668,0.000396,0.083064
2018,1,La Rioja,52228,17,52245,0.052228,1.7e-05,0.052245
2018,1,Mendoza,199463,1484,200947,0.199463,0.001484,0.200947
2018,1,Misiones,103580,0,103580,0.10358,0.0,0.10358
2018,1,Neuquén,115897,2006,117903,0.115897,0.002006,0.117903
2018,1,Río Negro,110057,1062,111119,0.110057,0.001062,0.111119
2018,1,Salta,133182,1,133183,0.133182,1e-06,0.133183
2018,1,San Juan,62610,658,63268,0.06261,0.000658,0.063268
2018,1,San Luis,21096,300,21396,0.021096,0.0003,0.021396
2018,1,Santa Cruz,33970,435,34405,0.03397,0.000435,0.034405
2018,1,Santa Fe,679717,309,680026,0.679717,0.000309,0.680026
2018,1,Santiago Del Estero,82916,2,82918,0.082916,2e-06,0.082918
2018,1,Tierra Del Fuego,31106,508,31614,0.031106,0.000508,0.031614
2018,1,Tucumán,168026,31,168057,0.168026,3.1e-05,0.168057
2017,4,Buenos Aires,3171206,10690,3181896,3.171206,0.01069,3.181896
2017,4,Capital Federal,1575418,6906,1582324,1.575418,0.006906,1.582324
2017,4,Catamarca,29548,10,29558,0.029548,1e-05,0.029558
2017,4,Chaco,96603,12,96615,0.096603,1.2e-05,0.096615
2017,4,Chubut,91012,2428,93440,0.091012,0.002428,0.09344
2017,4,Córdoba,709874,105,709979,0.709874,0.000105,0.709979
2017,4,Corrientes,93760,11,93771,0.09376,1.1e-05,0.093771
2017,4,Entre Ríos,193654,49,193703,0.193654,4.9e-05,0.193703
2017,4,Formosa,32056,0,32056,0.032056,0.0,0.032056
2017,4,Jujuy,43551,1,43552,0.043551,1e-06,0.043552
2017,4,La Pampa,81675,396,82071,0.081675,0.000396,0.082071
2017,4,La Rioja,52177,17,52194,0.052177,1.7e-05,0.052194
2017,4,Mendoza,178661,1490,180151,0.178661,0.00149,0.180151
2017,4,Misiones,103895,0,103895,0.103895,0.0,0.103895
2017,4,Neuquén,114965,2006,116971,0.114965,0.002006,0.116971
2017,4,Río Negro,108702,1062,109764,0.108702,0.001062,0.109764
2017,4,Salta,132811,1,132812,0.132811,1e-06,0.132812
2017,4,San Juan,57965,659,58624,0.057965,0.000659,0.058624
2017,4,San Luis,14604,300,14904,0.014604,0.0003,0.014904
2017,4,Santa Cruz,29018,434,29452,0.029018,0.000434,0.029452
2017,4,Santa Fe,672137,323,672460,0.672137,0.000323,0.67246
2017,4,Santiago Del Estero,68842,2,68844,0.068842,2e-06,0.068844
2017,4,Tierra Del Fuego,28346,508,28854,0.028346,0.000508,0.028854
2017,4,Tucumán,162298,34,162332,0.162298,3.4e-05,0.162332
2017,3,Buenos Aires,3046758,11202,3057960,3.046758,0.011202,3.05796
2017,3,Capital Federal,1563289,7070,1570359,1.563289,0.00707,1.570359
2017,3,Catamarca,33467,11,33478,0.033467,1.1e-05,0.033478
2017,3,Chaco,93747,12,93759,0.093747,1.2e-05,0.093759
2017,3,Chubut,81067,2477,83544,0.081067,0.002477,0.083544
2017,3,Córdoba,696536,108,696644,0.696536,0.000108,0.696644
2017,3,Corrientes,92536,12,92548,0.092536,1.2e-05,0.092548
2017,3,Entre Ríos,185414,50,185464,0.185414,5e-05,0.185464
2017,3,Formosa,32105,0,32105,0.032105,0.0,0.032105
2017,3,Jujuy,43241,1,43242,0.043241,1e-06,0.043242
2017,3,La Pampa,79280,410,79690,0.07928,0.00041,0.07969
2017,3,La Rioja,51896,17,51913,0.051896,1.7e-05,0.051913
2017,3,Mendoza,190958,1533,192491,0.190958,0.001533,0.192491
2017,3,Misiones,100476,0,100476,0.100476,0.0,0.100476
2017,3,Neuquén,113755,2029,115784,0.113755,0.002029,0.115784
2017,3,Río Negro,106393,1103,107496,0.106393,0.001103,0.107496
2017,3,Salta,132517,1,132518,0.132517,1e-06,0.132518
2017,3,San Juan,61789,660,62449,0.061789,0.00066,0.062449
2017,3,San Luis,21408,311,21719,0.021408,0.000311,0.021719
2017,3,Santa Cruz,33222,468,33690,0.033222,0.000468,0.03369
2017,3,Santa Fe,662086,256,662342,0.662086,0.000256,0.662342
2017,3,Santiago Del Estero,82792,2,82794,0.082792,2e-06,0.082794
2017,3,Tierra Del Fuego,30883,583,31466,0.030883,0.000583,0.031466
2017,3,Tucumán,160979,33,161012,0.160979,3.3e-05,0.161012
2017,2,Buenos Aires,3067430,11201,3078631,3.06743,0.011201,3.078631
2017,2,Capital Federal,1592175,8016,1600191,1.592175,0.008016,1.600191
2017,2,Catamarca,26692,13,26705,0.026692,1.3e-05,0.026705
2017,2,Chaco,90597,14,90611,0.090597,1.4e-05,0.090611
2017,2,Chubut,62245,1730,63975,0.062245,0.00173,0.063975
2017,2,Córdoba,657505,133,657638,0.657505,0.000133,0.657638
2017,2,Corrientes,90085,12,90097,0.090085,1.2e-05,0.090097
2017,2,Entre Ríos,182675,57,182732,0.182675,5.7e-05,0.182732
2017,2,Formosa,29956,0,29956,0.029956,0.0,0.029956
2017,2,Jujuy,42656,1,42657,0.042656,1e-06,0.042657
2017,2,La Pampa,72573,449,73022,0.072573,0.000449,0.073022
2017,2,La Rioja,16271,18,16289,0.016271,1.8e-05,0.016289
2017,2,Mendoza,169302,1451,170753,0.169302,0.001451,0.170753
2017,2,Misiones,99794,0,99794,0.099794,0.0,0.099794
2017,2,Neuquén,115321,2112,117433,0.115321,0.002112,0.117433
2017,2,Río Negro,100621,998,101619,0.100621,0.000998,0.101619
2017,2,Salta,108540,1,108541,0.10854,1e-06,0.108541
2017,2,San Juan,51261,620,51881,0.051261,0.00062,0.051881
2017,2,San Luis,12992,315,13307,0.012992,0.000315,0.013307
2017,2,Santa Cruz,26019,369,26388,0.026019,0.000369,0.026388
2017,2,Santa Fe,566918,362,567280,0.566918,0.000362,0.56728
2017,2,Santiago Del Estero,33194,2,33196,0.033194,2e-06,0.033196
2017,2,Tierra Del Fuego,31938,619,32557,0.031938,0.000619,0.032557
2017,2,Tucumán,154374,37,154411,0.154374,3.7e-05,0.154411
2017,1,Buenos Aires,3178174,11202,3189376,3.178174,0.011202,3.189376
2017,1,Capital Federal,1391030,8016,1399046,1.39103,0.008016,1.399046
2017,1,Catamarca,26304,13,26317,0.026304,1.3e-05,0.026317
2017,1,Chaco,89036,14,89050,0.089036,1.4e-05,0.08905
2017,1,Chubut,62166,1730,63896,0.062166,0.00173,0.063896
2017,1,Córdoba,641066,133,641199,0.641066,0.000133,0.641199
2017,1,Corrientes,88596,12,88608,0.088596,1.2e-05,0.088608
2017,1,Entre Ríos,180296,57,180353,0.180296,5.7e-05,0.180353
2017,1,Formosa,29705,0,29705,0.029705,0.0,0.029705
2017,1,Jujuy,43202,1,43203,0.043202,1e-06,0.043203
2017,1,La Pampa,71458,455,71913,0.071458,0.000455,0.071913
2017,1,La Rioja,16207,18,16225,0.016207,1.8e-05,0.016225
2017,1,Mendoza,169282,1451,170733,0.169282,0.001451,0.170733
2017,1,Misiones,97619,0,97619,0.097619,0.0,0.097619
2017,1,Neuquén,113227,2112,115339,0.113227,0.002112,0.115339
2017,1,Río Negro,100288,1000,101288,0.100288,0.001,0.101288
2017,1,Salta,107632,1,107633,0.107632,1e-06,0.107633
2017,1,San Juan,51253,620,51873,0.051253,0.00062,0.051873
2017,1,San Luis,12992,315,13307,0.012992,0.000315,0.013307
2017,1,Santa Cruz,26116,370,26486,0.026116,0.00037,0.026486
2017,1,Santa Fe,562520,362,562882,0.56252,0.000362,0.562882
2017,1,Santiago Del Estero,34473,2,34475,0.034473,2e-06,0.034475
2017,1,Tierra Del Fuego,31938,619,32557,0.031938,0.000619,0.032557
2017,1,Tucumán,152734,37,152771,0.152734,3.7e-05,0.152771
2016,4,Buenos Aires,3131499,11202,3142701,3.131499,0.011202,3.142701
2016,4,Capital Federal,1393443,8016,1401459,1.393443,0.008016,1.401459
2016,4,Catamarca,27021,13,27034,0.027021,1.3e-05,0.027034
2016,4,Chaco,88833,14,88847,0.088833,1.4e-05,0.088847
2016,4,Chubut,62035,1730,63765,0.062035,0.00173,0.063765
2016,4,Córdoba,636422,133,636555,0.636422,0.000133,0.636555
2016,4,Corrientes,88084,12,88096,0.088084,1.2e-05,0.088096
2016,4,Entre Ríos,180188,57,180245,0.180188,5.7e-05,0.180245
2016,4,Formosa,29513,0,29513,0.029513,0.0,0.029513
2016,4,Jujuy,42624,1,42625,0.042624,1e-06,0.042625
2016,4,La Pampa,71368,460,71828,0.071368,0.00046,0.071828
2016,4,La Rioja,16298,18,16316,0.016298,1.8e-05,0.016316
2016,4,Mendoza,169274,1451,170725,0.169274,0.001451,0.170725
2016,4,Misiones,97390,0,97390,0.09739,0.0,0.09739
2016,4,Neuquén,111723,2112,113835,0.111723,0.002112,0.113835
2016,4,Río Negro,100020,1000,101020,0.10002,0.001,0.10102
2016,4,Salta,106934,1,106935,0.106934,1e-06,0.106935
2016,4,San Juan,51301,620,51921,0.051301,0.00062,0.051921
2016,4,San Luis,12992,315,13307,0.012992,0.000315,0.013307
2016,4,Santa Cruz,26094,370,26464,0.026094,0.00037,0.026464
2016,4,Santa Fe,561470,362,561832,0.56147,0.000362,0.561832
2016,4,Santiago Del Estero,35049,2,35051,0.035049,2e-06,0.035051
2016,4,Tierra Del Fuego,31938,619,32557,0.031938,0.000619,0.032557
2016,4,Tucumán,151615,37,151652,0.151615,3.7e-05,0.151652
2016,3,Buenos Aires,3075387,11205,3086592,3.075387,0.011205,3.086592
2016,3,Capital Federal,1395053,8051,1403104,1.395053,0.008051,1.403104
2016,3,Catamarca,26957,13,26970,0.026957,1.3e-05,0.02697
2016,3,Chaco,89216,14,89230,0.089216,1.4e-05,0.08923
2016,3,Chubut,62222,1730,63952,0.062222,0.00173,0.063952
2016,3,Córdoba,642458,133,642591,0.642458,0.000133,0.642591
2016,3,Corrientes,88328,12,88340,0.088328,1.2e-05,0.08834
2016,3,Entre Ríos,181092,57,181149,0.181092,5.7e-05,0.181149
2016,3,Formosa,27716,0,27716,0.027716,0.0,0.027716
2016,3,Jujuy,42537,1,42538,0.042537,1e-06,0.042538
2016,3,La Pampa,69903,461,70364,0.069903,0.000461,0.070364
2016,3,La Rioja,16912,18,16930,0.016912,1.8e-05,0.01693
2016,3,Mendoza,169174,1450,170624,0.169174,0.00145,0.170624
2016,3,Misiones,97997,0,97997,0.097997,0.0,0.097997
2016,3,Neuquén,110491,2112,112603,0.110491,0.002112,0.112603
2016,3,Río Negro,100024,1002,101026,0.100024,0.001002,0.101026
2016,3,Salta,107790,1,107791,0.10779,1e-06,0.107791
2016,3,San Juan,51348,620,51968,0.051348,0.00062,0.051968
2016,3,San Luis,12978,315,13293,0.012978,0.000315,0.013293
2016,3,Santa Cruz,25886,371,26257,0.025886,0.000371,0.026257
2016,3,Santa Fe,566625,386,567011,0.566625,0.000386,0.567011
2016,3,Santiago Del Estero,35658,2,35660,0.035658,2e-06,0.03566
2016,3,Tierra Del Fuego,31306,619,31925,0.031306,0.000619,0.031925
2016,3,Tucumán,151282,37,151319,0.151282,3.7e-05,0.151319
2016,2,Buenos Aires,3032776,12515,3045291,3.032776,0.012515,3.045291
2016,2,Capital Federal,1384824,9760,1394584,1.384824,0.00976,1.394584
2016,2,Catamarca,26543,13,26556,0.026543,1.3e-05,0.026556
2016,2,Chaco,88235,16,88251,0.088235,1.6e-05,0.088251
2016,2,Chubut,62116,1740,63856,0.062116,0.00174,0.063856
2016,2,Córdoba,634680,234,634914,0.63468,0.000234,0.634914
2016,2,Corrientes,86932,24,86956,0.086932,2.4e-05,0.086956
2016,2,Entre Ríos,178194,179,178373,0.178194,0.000179,0.178373
2016,2,Formosa,28801,1,28802,0.028801,1e-06,0.028802
2016,2,Jujuy,41187,2,41189,0.041187,2e-06,0.041189
2016,2,La Pampa,68403,485,68888,0.068403,0.000485,0.068888
2016,2,La Rioja,16718,18,16736,0.016718,1.8e-05,0.016736
2016,2,Mendoza,169274,1550,170824,0.169274,0.00155,0.170824
2016,2,Misiones,95808,7,95815,0.095808,7e-06,0.095815
2016,2,Neuquén,108224,2291,110515,0.108224,0.002291,0.110515
2016,2,Río Negro,99631,1073,100704,0.099631,0.001073,0.100704
2016,2,Salta,104929,3,104932,0.104929,3e-06,0.104932
2016,2,San Juan,51392,621,52013,0.051392,0.000621,0.052013
2016,2,San Luis,12939,317,13256,0.012939,0.000317,0.013256
2016,2,Santa Cruz,25797,356,26153,0.025797,0.000356,0.026153
2016,2,Santa Fe,563867,607,564474,0.563867,0.000607,0.564474
2016,2,Santiago Del Estero,36958,3,36961,0.036958,3e-06,0.036961
2016,2,Tierra Del Fuego,30740,619,31359,0.03074,0.000619,0.031359
2016,2,Tucumán,148636,41,148677,0.148636,4.1e-05,0.148677
2016,1,Buenos Aires,2929903,12612,2942515,2.929903,0.012612,2.942515
2016,1,Capital Federal,1328079,9817,1337896,1.328079,0.009817,1.337896
2016,1,Catamarca,26376,13,26389,0.026376,1.3e-05,0.026389
2016,1,Chaco,86635,16,86651,0.086635,1.6e-05,0.086651
2016,1,Chubut,62060,1740,63800,0.06206,0.00174,0.0638
2016,1,Córdoba,609692,234,609926,0.609692,0.000234,0.609926
2016,1,Corrientes,85510,26,85536,0.08551,2.6e-05,0.085536
2016,1,Entre Ríos,174634,179,174813,0.174634,0.000179,0.174813
2016,1,Formosa,28313,1,28314,0.028313,1e-06,0.028314
2016,1,Jujuy,40287,2,40289,0.040287,2e-06,0.040289
2016,1,La Pampa,65442,487,65929,0.065442,0.000487,0.065929
2016,1,La Rioja,16673,18,16691,0.016673,1.8e-05,0.016691
2016,1,Mendoza,169257,1553,170810,0.169257,0.001553,0.17081
2016,1,Misiones,92951,7,92958,0.092951,7e-06,0.092958
2016,1,Neuquén,101969,2292,104261,0.101969,0.002292,0.104261
2016,1,Río Negro,98745,1077,99822,0.098745,0.001077,0.099822
2016,1,Salta,102423,3,102426,0.102423,3e-06,0.102426
2016,1,San Juan,51373,621,51994,0.051373,0.000621,0.051994
2016,1,San Luis,12915,317,13232,0.012915,0.000317,0.013232
2016,1,Santa Cruz,25931,356,26287,0.025931,0.000356,0.026287
2016,1,Santa Fe,551378,618,551996,0.551378,0.000618,0.551996
2016,1,Santiago Del Estero,37695,3,37698,0.037695,3e-06,0.037698
2016,1,Tierra Del Fuego,29867,619,30486,0.029867,0.000619,0.030486
2016,1,Tucumán,146596,41,146637,0.146596,4.1e-05,0.146637
2015,4,Buenos Aires,2946743,12642,2959385,2.946743,0.012642,2.959385
2015,4,Capital Federal,1360381,9845,1370226,1.360381,0.009845,1.370226
2015,4,Catamarca,26459,13,26472,0.026459,1.3e-05,0.026472
2015,4,Chaco,86537,16,86553,0.086537,1.6e-05,0.086553
2015,4,Chubut,62279,1740,64019,0.062279,0.00174,0.064019
2015,4,Córdoba,625835,235,626070,0.625835,0.000235,0.62607
2015,4,Corrientes,85409,26,85435,0.085409,2.6e-05,0.085435
2015,4,Entre Ríos,173957,180,174137,0.173957,0.00018,0.174137
2015,4,Formosa,28088,1,28089,0.028088,1e-06,0.028089
2015,4,Jujuy,39922,2,39924,0.039922,2e-06,0.039924
2015,4,La Pampa,66054,312,66366,0.066054,0.000312,0.066366
2015,4,La Rioja,16914,18,16932,0.016914,1.8e-05,0.016932
2015,4,Mendoza,169251,1556,170807,0.169251,0.001556,0.170807
2015,4,Misiones,92846,7,92853,0.092846,7e-06,0.092853
2015,4,Neuquén,105122,2294,107416,0.105122,0.002294,0.107416
2015,4,Río Negro,98655,1067,99722,0.098655,0.001067,0.099722
2015,4,Salta,101917,3,101920,0.101917,3e-06,0.10192
2015,4,San Juan,51408,621,52029,0.051408,0.000621,0.052029
2015,4,San Luis,12901,317,13218,0.012901,0.000317,0.013218
2015,4,Santa Cruz,26047,356,26403,0.026047,0.000356,0.026403
2015,4,Santa Fe,561045,627,561672,0.561045,0.000627,0.561672
2015,4,Santiago Del Estero,39132,3,39135,0.039132,3e-06,0.039135
2015,4,Tierra Del Fuego,29334,619,29953,0.029334,0.000619,0.029953
2015,4,Tucumán,146053,42,146095,0.146053,4.2e-05,0.146095
2015,3,Buenos Aires,2916070,12695,2928765,2.91607,0.012695,2.928765
2015,3,Capital Federal,1362193,9875,1372068,1.362193,0.009875,1.372068
2015,3,Catamarca,26080,13,26093,0.02608,1.3e-05,0.026093
2015,3,Chaco,85354,16,85370,0.085354,1.6e-05,0.08537
2015,3,Chubut,62143,1740,63883,0.062143,0.00174,0.063883
2015,3,Córdoba,622761,237,622998,0.622761,0.000237,0.622998
2015,3,Corrientes,84931,28,84959,0.084931,2.8e-05,0.084959
2015,3,Entre Ríos,172252,182,172434,0.172252,0.000182,0.172434
2015,3,Formosa,27751,1,27752,0.027751,1e-06,0.027752
2015,3,Jujuy,39548,2,39550,0.039548,2e-06,0.03955
2015,3,La Pampa,64976,495,65471,0.064976,0.000495,0.065471
2015,3,La Rioja,16753,18,16771,0.016753,1.8e-05,0.016771
2015,3,Mendoza,169261,1562,170823,0.169261,0.001562,0.170823
2015,3,Misiones,91615,7,91622,0.091615,7e-06,0.091622
2015,3,Neuquén,98376,2240,100616,0.098376,0.00224,0.100616
2015,3,Río Negro,98529,1085,99614,0.098529,0.001085,0.099614
2015,3,Salta,100570,3,100573,0.10057,3e-06,0.100573
2015,3,San Juan,51409,621,52030,0.051409,0.000621,0.05203
2015,3,San Luis,12902,317,13219,0.012902,0.000317,0.013219
2015,3,Santa Cruz,25912,359,26271,0.025912,0.000359,0.026271
2015,3,Santa Fe,556097,641,556738,0.556097,0.000641,0.556738
2015,3,Santiago Del Estero,39394,3,39397,0.039394,3e-06,0.039397
2015,3,Tierra Del Fuego,33118,619,33737,0.033118,0.000619,0.033737
2015,3,Tucumán,144272,42,144314,0.144272,4.2e-05,0.144314
2015,2,Buenos Aires,2871079,12711,2883790,2.871079,0.012711,2.88379
2015,2,Capital Federal,1336391,9893,1346284,1.336391,0.009893,1.346284
2015,2,Catamarca,25666,13,25679,0.025666,1.3e-05,0.025679
2015,2,Chaco,83832,16,83848,0.083832,1.6e-05,0.083848
2015,2,Chubut,61745,1740,63485,0.061745,0.00174,0.063485
2015,2,Córdoba,609510,236,609746,0.60951,0.000236,0.609746
2015,2,Corrientes,83288,28,83316,0.083288,2.8e-05,0.083316
2015,2,Entre Ríos,169309,183,169492,0.169309,0.000183,0.169492
2015,2,Formosa,27013,37,27050,0.027013,3.7e-05,0.02705
2015,2,Jujuy,37720,2,37722,0.03772,2e-06,0.037722
2015,2,La Pampa,63552,500,64052,0.063552,0.0005,0.064052
2015,2,La Rioja,16491,18,16509,0.016491,1.8e-05,0.016509
2015,2,Mendoza,169259,1564,170823,0.169259,0.001564,0.170823
2015,2,Misiones,88512,7,88519,0.088512,7e-06,0.088519
2015,2,Neuquén,95644,2241,97885,0.095644,0.002241,0.097885
2015,2,Río Negro,97640,1087,98727,0.09764,0.001087,0.098727
2015,2,Salta,98264,3,98267,0.098264,3e-06,0.098267
2015,2,San Juan,51367,621,51988,0.051367,0.000621,0.051988
2015,2,San Luis,12904,317,13221,0.012904,0.000317,0.013221
2015,2,Santa Cruz,25384,379,25763,0.025384,0.000379,0.025763
2015,2,Santa Fe,545739,649,546388,0.545739,0.000649,0.546388
2015,2,Santiago Del Estero,39375,3,39378,0.039375,3e-06,0.039378
2015,2,Tierra Del Fuego,32960,619,33579,0.03296,0.000619,0.033579
2015,2,Tucumán,140635,42,140677,0.140635,4.2e-05,0.140677
2015,1,Buenos Aires,2847076,14766,2861842,2.847076,0.014766,2.861842
2015,1,Capital Federal,1321139,11582,1332721,1.321139,0.011582,1.332721
2015,1,Catamarca,25312,20,25332,0.025312,2e-05,0.025332
2015,1,Chaco,81329,31,81360,0.081329,3.1e-05,0.08136
2015,1,Chubut,63327,1946,65273,0.063327,0.001946,0.065273
2015,1,Córdoba,596663,294,596957,0.596663,0.000294,0.596957
2015,1,Corrientes,81488,43,81531,0.081488,4.3e-05,0.081531
2015,1,Entre Ríos,165839,231,166070,0.165839,0.000231,0.16607
2015,1,Formosa,26657,43,26700,0.026657,4.3e-05,0.0267
2015,1,Jujuy,36608,3,36611,0.036608,3e-06,0.036611
2015,1,La Pampa,62155,542,62697,0.062155,0.000542,0.062697
2015,1,La Rioja,16310,23,16333,0.01631,2.3e-05,0.016333
2015,1,Mendoza,168355,1805,170160,0.168355,0.001805,0.17016
2015,1,Misiones,85139,7,85146,0.085139,7e-06,0.085146
2015,1,Neuquén,93373,2369,95742,0.093373,0.002369,0.095742
2015,1,Río Negro,96145,1188,97333,0.096145,0.001188,0.097333
2015,1,Salta,96793,18,96811,0.096793,1.8e-05,0.096811
2015,1,San Juan,51117,702,51819,0.051117,0.000702,0.051819
2015,1,San Luis,12878,354,13232,0.012878,0.000354,0.013232
2015,1,Santa Cruz,26217,424,26641,0.026217,0.000424,0.026641
2015,1,Santa Fe,535640,797,536437,0.53564,0.000797,0.536437
2015,1,Santiago Del Estero,39244,8,39252,0.039244,8e-06,0.039252
2015,1,Tierra Del Fuego,32726,730,33456,0.032726,0.00073,0.033456
2015,1,Tucumán,138184,92,138276,0.138184,9.2e-05,0.138276
2014,4,Buenos Aires,2801178,15229,2816407,2.801178,0.015229,2.816407
2014,4,Capital Federal,1318526,11994,1330520,1.318526,0.011994,1.33052
2014,4,Catamarca,25472,21,25493,0.025472,2.1e-05,0.025493
2014,4,Chaco,65998,37,66035,0.065998,3.7e-05,0.066035
2014,4,Chubut,66557,1985,68542,0.066557,0.001985,0.068542
2014,4,Córdoba,590113,319,590432,0.590113,0.000319,0.590432
2014,4,Corrientes,65656,54,65710,0.065656,5.4e-05,0.06571
2014,4,Entre Ríos,140567,246,140813,0.140567,0.000246,0.140813
2014,4,Formosa,26156,51,26207,0.026156,5.1e-05,0.026207
2014,4,Jujuy,35999,3,36002,0.035999,3e-06,0.036002
2014,4,La Pampa,56813,567,57380,0.056813,0.000567,0.05738
2014,4,La Rioja,16379,23,16402,0.016379,2.3e-05,0.016402
2014,4,Mendoza,167766,1848,169614,0.167766,0.001848,0.169614
2014,4,Misiones,77222,7,77229,0.077222,7e-06,0.077229
2014,4,Neuquén,92999,2397,95396,0.092999,0.002397,0.095396
2014,4,Río Negro,95050,1210,96260,0.09505,0.00121,0.09626
2014,4,Salta,93921,26,93947,0.093921,2.6e-05,0.093947
2014,4,San Juan,51390,729,52119,0.05139,0.000729,0.052119
2014,4,San Luis,12788,359,13147,0.012788,0.000359,0.013147
2014,4,Santa Cruz,25277,436,25713,0.025277,0.000436,0.025713
2014,4,Santa Fe,528459,938,529397,0.528459,0.000938,0.529397
2014,4,Santiago Del Estero,39308,9,39317,0.039308,9e-06,0.039317
2014,4,Tierra Del Fuego,28249,741,28990,0.028249,0.000741,0.02899
2014,4,Tucumán,137329,95,137424,0.137329,9.5e-05,0.137424
2014,3,Buenos Aires,2835537,14028,2849565,2.835537,0.014028,2.849565
2014,3,Capital Federal,1307195,10630,1317825,1.307195,0.01063,1.317825
2014,3,Catamarca,24665,21,24686,0.024665,2.1e-05,0.024686
2014,3,Chaco,63710,36,63746,0.06371,3.6e-05,0.063746
2014,3,Chubut,67130,2007,69137,0.06713,0.002007,0.069137
2014,3,Córdoba,585231,200,585431,0.585231,0.0002,0.585431
2014,3,Corrientes,63516,33,63549,0.063516,3.3e-05,0.063549
2014,3,Entre Ríos,136618,115,136733,0.136618,0.000115,0.136733
2014,3,Formosa,25873,64,25937,0.025873,6.4e-05,0.025937
2014,3,Jujuy,33739,2,33741,0.033739,2e-06,0.033741
2014,3,La Pampa,61861,564,62425,0.061861,0.000564,0.062425
2014,3,La Rioja,15893,23,15916,0.015893,2.3e-05,0.015916
2014,3,Mendoza,166184,1740,167924,0.166184,0.00174,0.167924
2014,3,Misiones,75327,0,75327,0.075327,0.0,0.075327
2014,3,Neuquén,100099,2268,102367,0.100099,0.002268,0.102367
2014,3,Río Negro,96629,1151,97780,0.096629,0.001151,0.09778
2014,3,Salta,92929,25,92954,0.092929,2.5e-05,0.092954
2014,3,San Juan,51031,748,51779,0.051031,0.000748,0.051779
2014,3,San Luis,12683,363,13046,0.012683,0.000363,0.013046
2014,3,Santa Cruz,25664,446,26110,0.025664,0.000446,0.02611
2014,3,Santa Fe,520196,691,520887,0.520196,0.000691,0.520887
2014,3,Santiago Del Estero,37539,9,37548,0.037539,9e-06,0.037548
2014,3,Tierra Del Fuego,28037,755,28792,0.028037,0.000755,0.028792
2014,3,Tucumán,131978,88,132066,0.131978,8.8e-05,0.132066
2014,2,Buenos Aires,2750430,14116,2764546,2.75043,0.014116,2.764546
2014,2,Capital Federal,1299502,10713,1310215,1.299502,0.010713,1.310215
2014,2,Catamarca,24660,23,24683,0.02466,2.3e-05,0.024683
2014,2,Chaco,63243,36,63279,0.063243,3.6e-05,0.063279
2014,2,Chubut,68503,2016,70519,0.068503,0.002016,0.070519
2014,2,Córdoba,576747,205,576952,0.576747,0.000205,0.576952
2014,2,Corrientes,62925,33,62958,0.062925,3.3e-05,0.062958
2014,2,Entre Ríos,135468,115,135583,0.135468,0.000115,0.135583
2014,2,Formosa,25535,65,25600,0.025535,6.5e-05,0.0256
2014,2,Jujuy,34359,2,34361,0.034359,2e-06,0.034361
2014,2,La Pampa,55048,580,55628,0.055048,0.00058,0.055628
2014,2,La Rioja,15889,23,15912,0.015889,2.3e-05,0.015912
2014,2,Mendoza,165046,1761,166807,0.165046,0.001761,0.166807
2014,2,Misiones,74689,0,74689,0.074689,0.0,0.074689
2014,2,Neuquén,90053,2235,92288,0.090053,0.002235,0.092288
2014,2,Río Negro,94812,1145,95957,0.094812,0.001145,0.095957
2014,2,Salta,91949,25,91974,0.091949,2.5e-05,0.091974
2014,2,San Juan,50891,755,51646,0.050891,0.000755,0.051646
2014,2,San Luis,12691,364,13055,0.012691,0.000364,0.013055
2014,2,Santa Cruz,26710,459,27169,0.02671,0.000459,0.027169
2014,2,Santa Fe,511753,605,512358,0.511753,0.000605,0.512358
2014,2,Santiago Del Estero,38002,9,38011,0.038002,9e-06,0.038011
2014,2,Tierra Del Fuego,27443,766,28209,0.027443,0.000766,0.028209
2014,2,Tucumán,131981,88,132069,0.131981,8.8e-05,0.132069
2014,1,Buenos Aires,2725732,14144,2739876,2.725732,0.014144,2.739876
2014,1,Capital Federal,1289204,10714,1299918,1.289204,0.010714,1.299918
2014,1,Catamarca,24209,23,24232,0.024209,2.3e-05,0.024232
2014,1,Chaco,62520,36,62556,0.06252,3.6e-05,0.062556
2014,1,Chubut,68205,2016,70221,0.068205,0.002016,0.070221
2014,1,Córdoba,566705,205,566910,0.566705,0.000205,0.56691
2014,1,Corrientes,62203,33,62236,0.062203,3.3e-05,0.062236
2014,1,Entre Ríos,134216,115,134331,0.134216,0.000115,0.134331
2014,1,Formosa,25335,87,25422,0.025335,8.7e-05,0.025422
2014,1,Jujuy,33825,2,33827,0.033825,2e-06,0.033827
2014,1,La Pampa,53601,592,54193,0.053601,0.000592,0.054193
2014,1,La Rioja,15688,23,15711,0.015688,2.3e-05,0.015711
2014,1,Mendoza,164084,1761,165845,0.164084,0.001761,0.165845
2014,1,Misiones,73950,0,73950,0.07395,0.0,0.07395
2014,1,Neuquén,88077,2303,90380,0.088077,0.002303,0.09038
2014,1,Río Negro,93909,1157,95066,0.093909,0.001157,0.095066
2014,1,Salta,91265,25,91290,0.091265,2.5e-05,0.09129
2014,1,San Juan,50543,755,51298,0.050543,0.000755,0.051298
2014,1,San Luis,12193,364,12557,0.012193,0.000364,0.012557
2014,1,Santa Cruz,26304,460,26764,0.026304,0.00046,0.026764
2014,1,Santa Fe,506000,612,506612,0.506,0.000612,0.506612
2014,1,Santiago Del Estero,37124,9,37133,0.037124,9e-06,0.037133
2014,1,Tierra Del Fuego,27272,766,28038,0.027272,0.000766,0.028038
2014,1,Tucumán,129944,88,130032,0.129944,8.8e-05,0.130032
